2 13 31
###############################
#p   * * *  b  *    * * *   f #
# # # # ## # # # # # # ##     #
# 1 * *   x  * *   2   # # # ##
# # ## ## # ### # # #   # #   #
#*  *  *   *  1     *         #
# # # # # # # # # # # #    #*##
#   s   *  *  *      *   #  # #
# # # # ## # # ## # #    #  2 #
#     **   *      *  b   #  # #
# # # # # # # # # # # #  #  # #
#   * *   *  *    *   x       #
###############################