3 13 31
###############################
#p *   *  f  * * *   b        #
# # # # * # # # # # # # # # ###
* 1 * *    x  * *   2   *     #
# # # # ## # ## # # # #       #
**   *  *  *  1     *         #
# # # # # # # # # # # # #     #
*   s   * *  *      *         #
# # # # # # # * # # # # #     #
*  *     **      *  b   *     #
# # # # # # # # # # # # #     #
f  * *    *  *  *    x        #
###############################

