2 13 31
###############################
#p   * * *  b  *    * * *   f#

# # # # ## # # # # # # ##

* 1 * *   x  * *   2

# # ## ## # ### # # #

**  *  *   *  1     *

# # # # # # # # # # # # #

*   s   *  *  *      *

# # # # ## # # ## # # #

*     **   *      *  b

# # # # # # # # # # # # #

f   * *   *  *    *   x

###############################