3 13 31
###############################
#p   * 1* *  * 2 *3 *  *  * * #
# # #*# # # #*#*# #*# # # # # #
# *   *    ***  *   *   *  x  #
#*# # # # # # # #*#*#*#*#*#*# #
# * *  f  *  1     * *   *    #
# # # # # #*#*# # # # # #*# # #
#  * *  *     *   *   *    *  #
# # # # # # # # # # #*# # #*# #
# *  * 2  * b   3    *  *   * #
# #*# # # # # # # # # # # # # #
#    *     s   *   *      *   #
###############################


